W W W W W W W W W W W W W W W W W W W
W S S S S S S S S W S S S S S S S S W
W B W W S W W W W W W W W W S W W B W
W S S S S S S S S S S S S S S S S S W
W S W W S W S W W W W W S W S W W S W
W S S S S W S S S W S S S W S S S S W
W W W W S W W W S W S W W W S W W W W
E E E W S W S S S S S S S W S W E E E
W W W W S W S W S W S W S W S W W W W
E E E E S S S W S S S W S S S E E E E
W W W W S W S W W W W W S W S W W W W
E E E W S W S S S S S S S W S W E E E
W W W W S W S W W W W W S W S W W W W
W S S S S S S S S W S S S S S S S S W
W B W W S W W W W W W W W W S W W B W
W S S W S S S S S S S S S S S W S S W
W W S W S W S W W W W W S W S W S W W
W S S S S W S S S W S S S W S S S S W
W S W W W W W W S W S W W W W W W S W
W S S S S S S S S S S S S S S S S S W
W W W W W W W W W W W W W W W W W W W